        1111111111111111111111111
        1000000000110000000000001
        1011000001110000000000001
        1001000000000000000000001
111111111011000001110000000P00001
100000000011000001110111111111111
11110111111111011100000000001
111101111111110111010100000011
11000000110101011000000000001
10000000000000001000000000001
11000000110101011000000000001
10000000000000001000000000001
11000000110101011000000000001
10000000000000001000000000001
11000000110101011000000000001
10000000000000001000000000001
1100000011010101100000000000111111
1000000000000000100000000000000001
1100000011010101100000000000000001
1000000000000000100000000000111111
10000000000000001001010000001
1100000111010101101101111000111
11110111 1110101 101111010001
11111111 1111111 111111111111