           1111111111111111111111
11100011111110000000000001
   111100000111000000001111111111
 1111000000000000000000001000000011
111111111011000001110000011111111
100000000011000001110111111111111
11111111111101011111110010001
      1111110111     110001
11111111111101011101010010001
11000000110101011100000010001
1P1000000000000001100000000001
10000000000000000000010010001
110000011101111111110111100111
11110111011        101101010111
   1000111111111111111111111111
   1000111111111111111111111111
   1111111111111111111111111111