NO ./textures/girl_with_a_pearl_earring.png
SO      ./textures/Wheat_Field.png
WE       ./textures/the_tower_of_babel.png
EA      ./textures/Mona_Lisa.png

C       0,0,
F       0,0,0

        1111111111111111111111111
        1000000000110000000000011
        1011000001110000000000011
        1001000000000000000000001
111111111011000001110000000000001
10000000001100000111011111111111
11110111111111011100000000001
111101111111110111010100000011
11000000110101011000000000001
10000000000000001000000000001
11100000011010101100000000000111111
10000000000000000100000000000000001
1100000011010101100000000000000001
1000000000000000100000000000111111
10000000000000001001010000001
1100000111010101101101111000111
11110111 1110101 101111010N01
11111111 1111111 11111111111
