NO      ./textures/file.png
SO      ./textures/image_2.png
WE      ./textures/image_3.png
EA      ./textures/image_5.png

C 225,30,0
F 220,100,10

        1111111111111111111111111
        10000000001100000000000P1
        10110000011100000000000N1
        1001000000000000000000001
111111111011000001110000000000001
100000000011000001110111111111111
11110111111111011100000000001
111101111111110111010100000011
11000000110101011000000000001
10000000000000001000000000001
11000000110101011000000000001
10000000000000001000000000001
11000000110101011000000000001
10000000000000001000000000001
11000000110101011000000000001
10000000000000001000000000001
1100000011010101100000000000111111
1000000000000000100000000000000001
1100000011010101100000000000000001
1000000000000000100000000000111111
10000000000000001001010000001
1100000111010101101101111000111
11110111 1110101 101111010001
11111111 1111111 111111111111
