NO      ./textures/girl_with_a_pearl_earring.png
SO      ./textures/Wheat_Field.png
WE      ./textures/the_tower_of_babel.png
EA      ./textures/Mona_Lisa.png

C 173,216,230
F 123,63,0



11111111111111111111111111111
11100011111110000000000001
   1111000001110000000001111111111
 1111000000000000000000001000000011
111111111011000001110000011111111
100000000011000001110011111111111
11111111111101011111100010001
      1111110111111111100011111
11111111111101011101010010001
11000000110101011100000010001
101000110000000001100000000001
10000000000000000000010010001
1100N0011101111111110111100111
11110111011        101101010111
   1000111111111111111111111111
   1000111111111111111111111111
   1111111111111111111111111111
