NO      ./textures/image_1.png
SO      ./textures/image_2.png
WE      ./textures/image_3.png
EA      ./textures/image_5.png

C 225,30,0
F 220,100,10



11111111111111111111111111111
11100011111110000000000001
   1111000001110000001101111111111
 11110000000000000000N0001000000011
111111111011000001110000011111111
100000000011000001110111111111111
11111111111101011111110010001
      1111110111111111100011111
11111111111101011101010010001
11000000110101011100000010001
101000110000000001100000000001
10000000000000000000010010001
110000011101111111110111100111
11110111011        101101010111
   1000111111111111111111111111
   1000111111111111111111111111
   1111111111111111111111111111
