NO      ./textures/the_scream.png
SO      ./textures/Wheat_Field.png
WE      ./textures/the_tower_of_babel.png
EA      ./textures/Mo na _Li sa.png
C                  225,30,02
F                           220,101,10



        1111111111111111111111111
        1000000000110000000000001
        1011000001110000000000001
        1001000000000000010010001
111111111011000001110000E00000001
100000000011000001110111111111111
11110111111111011100000010001
11110111111111011101010010001
11000000110101010100000010001
100000000001000001000000100011
10000000001 1000000101010010001
110000011101010010000000101111
11110111 1110101 101111010001
11111111 1111111 111111111111
1
11
101
11
11111111 1111111 111111111111
