
NO      ./textures/girl_with_a_pearl_earring.png
SO      ./textures/Wheat_Field.png
WE      ./textures/the_tower_of_babel.png
EA      ./textures/Mona_Lisa.png
C       0,0,0
F       0,0,0


        1111111111111111111111111
        1000000000110000000000001
        1011000001110000000000001
        10010000000000000000W0001
111111111011000001110000000000001
100000000011000001110111111111111
11110111111111011100000010001
11110111111111011101010010001
11000000110101010100000010001
10000000000000000100000010001
10000000000000000101010010001
11000001110101001000000010111
11110111 1110101 101111010001
11111111 1111111 111111111111
