NO      ./textures/girl_with_a_pearl_earring.png
SO      ./textures/Wheat_Field.png
WE      ./textures/the_tower_of_babel.png
EA      ./textures/Mona_Lisa.png

C       0,0,100
F       0,0,0

        11111111111111111111111111
        1000000000110000000000001
        1011000001110000000000001
        1001000000000000000000001
11111111101100000111000000000001
100000000011000001110111111111111
11110111111111011100000010001
11110111111111011101010010001
11000000110101010100000010001
11111111111111111111111111111
10000000000000000100000010001
10000000000000000101010010001
11000000111010100100000S01011
10010111 11101011101111010001
11111111 1111111 111111111111









































